R 10000 10000

NO     ./textures/north.xpm

SO   ./textures/south.xpm

WE ./textures/west.xpm

EA ./textures/east.xpm

S ./textures/sprite.xpm

F  255,153,0

C   153,51,255


        1111111111111111111111111
        1000020000110000000000001
        1011000001110020000200021
        1001002000200000002000001
111111111011000001110020000000001
100000000011020001110111110111111111
11110111111111011100000010021
11110111111111011101010010001
11000020110101011100020010001
10001000002000021100000012001  
10002002000000201101010000021    
11002001110121011111011110N0111
11112111 1110101 101111010001   
11111111 1111111 111111111111

