R 520 480

NO     ./textures/north.xpm

SO   ./textures/south.xpm

WE ./textures/west.xpm

EA ./textures/east.xpm

S ./textures/sprite.xpm

F  204,51,0

C   153,51,255

11111111111111
10000000000001
10000000000001
10000000000001
10000000000001
10000000000001
100000N0000001
10000000000001
10000000000001
10000000000001
10000000000001
11111111111111
